555555000055555
555555555555555
555544455555555
211111111111555
500055444551555
555500005551555
555111111111555
555144554444555
555111111111113
000005555444555
505055000005555