211155111155555
555155155155513
555114155111515
555414111551515
111114551551515
155555551151115
111551115155555
551111515111111
555555515555551
555555511111111
505055555555555