555555555055555
211115550555555
555414550550555
555414555555555
555414555055555
511115555505555
514445555550505
511115545555555
555511115544455
555554411111155
505055555555113